5 5 5 5 5 5 5 5 5 5 5 5 5 5 0 0 0 0 0 0 0 5 5 5 5 5 5 5 5 5 5 5 5 5 5 5 5 5 5 5 5 5 5 5 5 5 5 5 5 5
5 5 5 5 5 5 5 5 5 5 5 5 0 0 0 2 1 4 4 4 0 0 0 5 5 5 5 5 5 5 5 5 5 5 5 5 5 5 5 5 5 5 5 5 5 5 5 5 5 5
5 5 5 5 5 5 5 5 5 5 0 0 0 2 2 3 1 4 4 4 4 4 0 0 0 5 5 5 5 5 5 5 5 5 5 5 5 5 5 5 5 5 5 5 5 5 5 5 5 5
5 5 5 5 5 5 5 5 0 0 0 2 2 3 3 1 2 4 4 4 4 4 4 4 0 0 0 5 5 5 5 5 5 5 5 5 5 5 5 5 5 5 5 5 5 5 5 5 5 5
5 5 5 5 5 5 0 0 0 2 2 3 3 1 1 1 3 4 4 4 4 4 4 4 4 4 0 0 0 5 5 5 5 5 5 5 5 5 5 5 5 5 5 5 5 5 5 5 5 5
5 5 5 5 0 0 0 2 2 3 3 1 1 1 2 1 1 4 4 4 4 4 4 4 4 4 4 4 0 0 0 5 5 5 5 5 5 5 5 5 5 5 5 5 5 5 5 5 5 5
5 0 0 0 0 2 2 3 3 1 1 1 2 1 1 1 2 4 4 4 4 4 4 4 4 4 4 4 4 4 0 0 0 5 5 5 5 5 5 5 5 5 5 5 5 5 5 5 5 5
0 0 2 2 2 3 3 1 1 2 1 1 3 1 1 1 3 4 4 4 4 4 1 4 4 4 4 4 4 4 4 4 0 0 0 5 5 5 5 5 5 5 5 5 5 5 5 5 5 5
0 2 3 3 3 1 1 1 1 3 1 1 1 1 2 1 1 4 4 4 4 4 4 4 4 4 4 4 4 4 4 4 4 4 0 0 0 5 5 5 5 5 5 5 5 5 5 5 5 5
0 3 1 1 1 1 1 1 2 1 1 1 1 1 3 1 2 4 4 4 4 1 4 4 4 4 4 4 4 4 4 4 4 4 4 4 0 0 0 5 5 5 5 5 5 5 5 5 5 5
0 2 1 1 1 2 1 1 3 1 1 2 1 1 1 1 3 4 4 4 4 4 4 4 4 4 4 4 1 4 4 4 4 4 4 4 4 4 0 0 0 5 5 5 5 5 5 5 5 5
0 3 1 1 1 3 1 1 1 1 2 3 2 1 1 1 1 4 4 4 4 4 4 4 4 4 4 4 4 4 4 4 4 4 1 4 4 4 4 4 0 0 0 5 5 5 5 5 5 5
0 2 1 1 2 1 1 1 1 1 3 1 3 1 1 1 2 4 4 4 4 4 4 1 4 4 4 4 4 4 4 4 4 4 4 4 4 4 4 4 4 4 0 0 0 5 5 5 5 5
0 3 1 1 3 1 1 2 1 1 1 1 1 1 1 1 3 4 4 1 4 4 4 4 4 4 4 4 4 4 4 1 4 4 4 4 4 4 4 4 4 4 4 4 0 0 0 5 5 5
0 2 1 1 1 1 1 3 1 1 1 1 1 1 1 1 1 4 4 4 4 4 4 4 4 4 4 4 4 4 4 4 4 4 4 4 4 4 4 4 4 4 4 4 4 4 0 0 0 5
0 3 1 1 1 1 1 1 2 1 1 1 2 2 1 1 2 4 4 4 4 4 4 4 4 4 4 4 4 4 4 4 4 4 4 4 4 4 4 4 4 4 4 4 4 4 4 4 0 0
0 2 1 1 1 2 2 1 3 1 2 1 3 3 1 1 3 4 4 4 4 1 4 4 4 4 4 4 4 4 4 4 4 1 4 4 4 4 4 4 4 4 4 4 4 4 4 4 4 0
0 3 1 1 1 3 3 1 1 1 3 1 1 1 1 1 1 4 4 4 4 4 4 4 4 4 4 4 4 4 4 4 4 4 4 4 4 4 4 4 1 4 4 4 4 4 4 4 4 0
0 2 1 1 2 1 1 1 1 1 1 1 1 1 2 1 1 4 4 4 4 4 4 4 4 4 1 4 4 4 4 4 4 4 4 1 4 4 4 4 4 4 4 4 4 4 4 4 4 0
0 3 1 1 3 2 1 1 1 1 1 1 1 1 3 1 4 4 4 4 4 4 1 4 4 4 4 4 4 4 4 4 4 4 4 4 4 4 4 4 4 4 4 4 4 4 4 4 4 0
0 2 1 1 1 3 1 2 1 1 2 2 1 1 1 4 4 4 4 4 4 4 4 4 4 4 4 4 4 4 4 4 4 4 4 4 4 4 4 4 4 4 4 4 4 4 4 4 4 0
0 3 1 1 1 1 1 3 1 1 3 3 1 1 4 4 4 4 4 4 4 4 4 4 4 4 4 4 4 4 4 4 4 4 4 4 4 4 4 4 4 4 1 4 4 4 4 4 4 0
0 2 1 1 1 1 2 1 1 1 1 2 1 4 4 4 4 4 4 1 4 4 4 4 4 4 4 4 4 4 4 4 4 4 4 1 4 4 4 4 4 4 4 4 4 4 4 4 4 0
0 3 1 1 2 1 3 1 1 2 1 3 4 4 4 4 4 4 4 4 4 4 4 4 4 4 4 6 7 4 4 4 4 4 4 4 4 4 4 4 4 4 4 4 4 4 4 4 4 0
0 2 1 1 3 1 1 1 1 3 1 1 4 4 4 4 4 4 4 4 4 1 4 4 4 4 4 8 9 4 4 4 4 4 4 4 4 4 4 4 4 4 4 4 4 4 4 4 4 0
0 3 1 1 1 1 1 2 1 1 1 1 1 4 4 4 4 4 4 4 4 4 4 4 4 4 4 4 4 4 4 4 4 4 4 4 4 4 4 4 4 4 4 4 1 4 4 4 4 0
0 2 1 1 1 1 2 3 1 1 1 1 1 1 4 4 4 4 4 4 4 4 4 4 4 4 4 4 4 4 4 4 4 4 4 4 4 4 4 4 4 4 4 4 4 4 4 4 4 0
0 3 1 1 1 1 3 2 1 1 1 1 1 2 4 4 4 4 4 4 4 4 4 4 1 4 4 4 4 4 4 4 4 4 4 4 4 4 4 1 4 4 4 4 4 4 4 4 4 0
0 2 1 1 2 1 1 3 1 1 1 1 1 3 1 4 4 4 4 4 1 4 4 4 4 4 4 4 4 4 4 4 4 4 4 4 4 4 4 4 4 4 4 4 4 4 4 4 4 0
0 3 1 1 3 1 1 1 1 1 2 1 2 1 1 1 4 4 4 4 4 4 4 4 4 4 4 4 4 4 4 4 4 1 4 4 4 4 4 4 4 4 4 4 4 4 4 4 4 0
0 2 1 2 1 1 2 1 1 1 3 1 3 1 1 1 2 4 4 4 4 4 4 4 4 4 4 4 4 4 4 4 4 4 4 4 4 4 4 4 4 4 4 4 1 4 4 4 4 0
0 3 1 3 1 1 3 1 1 1 2 2 1 1 1 1 3 4 4 4 4 4 4 4 4 4 4 4 4 4 4 4 4 4 4 4 4 4 4 4 4 4 4 4 4 4 4 4 4 0
0 2 1 1 1 1 1 1 1 1 3 3 1 1 1 1 1 4 4 4 4 4 4 1 4 4 4 4 4 4 4 4 4 4 4 4 4 4 4 1 4 4 4 4 4 4 4 4 4 0
0 3 1 1 1 1 1 2 1 1 1 2 1 1 1 1 2 4 4 4 4 4 4 4 4 4 4 4 4 4 1 4 4 4 4 4 4 4 4 4 4 4 4 4 4 4 4 4 4 0
0 2 1 1 1 1 1 3 1 1 1 3 1 1 1 1 3 4 4 4 4 4 4 4 4 4 4 4 4 4 4 4 4 4 4 4 4 4 4 4 4 4 4 4 4 4 4 4 4 0
0 3 1 1 1 2 2 1 2 1 1 1 1 1 1 1 1 4 4 4 4 4 4 4 4 4 4 4 4 4 4 4 4 4 4 4 4 4 4 4 4 4 4 1 4 4 4 4 4 0
0 2 1 1 1 3 3 1 3 1 1 1 2 1 1 1 2 4 4 4 4 4 4 4 4 4 4 4 4 4 4 4 1 4 4 4 4 4 4 4 4 4 4 4 4 4 4 4 4 0
0 3 1 1 1 1 1 1 1 1 2 1 3 2 1 1 3 4 4 4 4 4 4 4 4 4 4 4 4 4 4 4 4 4 4 4 4 4 4 4 4 4 4 4 4 4 4 4 4 0
0 2 1 1 1 2 1 1 1 1 3 1 1 3 1 1 1 4 4 4 4 4 4 4 4 4 4 4 4 4 4 4 4 4 4 4 4 4 4 4 4 4 4 4 4 4 4 4 4 0
0 3 1 1 1 3 1 1 2 1 1 1 1 1 1 1 2 4 4 4 4 4 4 4 4 1 4 4 4 4 4 4 4 4 4 4 4 4 4 4 4 4 4 4 4 4 4 4 4 0
0 2 1 1 1 1 1 1 3 1 1 2 1 1 2 1 3 4 4 4 4 4 4 4 4 4 4 4 4 4 4 4 4 4 4 4 4 4 4 4 4 4 4 1 4 4 4 4 4 0
0 3 2 1 1 1 1 1 2 1 1 3 1 1 3 1 1 4 4 4 4 1 4 4 4 4 4 4 4 4 4 4 4 1 4 4 4 4 4 4 4 4 4 4 4 4 4 4 4 0
0 0 3 1 1 2 1 1 3 1 1 1 1 1 1 1 2 4 4 4 4 4 4 4 4 4 4 4 4 4 4 4 4 4 4 4 4 4 4 4 4 4 4 4 4 4 4 4 4 0
5 0 0 0 0 3 1 2 1 1 1 1 2 1 1 1 3 4 4 4 4 4 4 4 4 4 4 4 4 4 4 4 4 4 4 4 4 4 4 4 4 4 4 4 4 4 4 4 4 0
5 5 5 5 0 0 0 3 1 2 1 1 3 1 1 1 1 4 4 4 4 4 4 4 1 4 4 4 4 4 4 4 4 4 4 4 4 4 4 4 4 4 4 4 1 4 4 4 4 0
5 5 5 5 5 5 0 0 0 3 1 2 1 1 1 1 2 4 4 4 4 4 4 4 4 4 4 4 4 4 4 4 4 4 4 4 4 4 4 4 4 4 4 4 4 4 4 4 4 0
5 5 5 5 5 5 5 5 0 0 0 3 1 2 1 1 3 4 4 4 4 4 4 4 4 4 4 4 4 4 4 4 4 4 4 1 4 4 4 4 4 4 4 4 4 4 4 4 4 0
5 5 5 5 5 5 5 5 5 5 0 0 0 3 1 2 1 4 4 4 4 4 4 4 4 4 4 4 4 4 4 4 4 4 4 4 4 4 4 4 4 4 4 4 4 4 4 4 4 0
5 5 5 5 5 5 5 5 5 5 5 5 0 0 0 3 1 4 4 4 4 4 4 4 4 4 4 4 4 4 4 4 4 4 4 4 4 4 4 4 4 4 4 4 4 4 4 4 4 0
5 5 5 5 5 5 5 5 5 5 5 5 5 5 0 0 0 0 0 0 0 0 0 0 0 0 0 0 0 0 0 0 0 0 0 0 0 0 0 0 0 0 0 0 0 0 0 0 0 0